　　	Rarikkusu
100円	100 Yen
398(さくや)	Sakuya
crebow くりぼー	
IFルート	IFroute
Meno_メノ	
Menou_メノウ	
Soyた	SoyTa
TG(トリグリ)	Toriguri
TV/シダレザクラ	Sidarezakura
Yン	Yn
ZAIガス	ZAIgass
Σカリウム	ΣKalium
あcola	acola
アイギス大山	Aegis Ohyama
アイゴスキー	Aygoski
あいす	Ice
アインス	Eins
あかとんぼ	Akatombo
あきゅわん	Aqua
あくろす	Across
アザラッシュ	Azarasi
あしも	Asimo
アス	asu
あすと	Asto
アストラ	Astra
アセロラおじさん	Acerola Ojisan
あつむ	Atumu
アニアニ	AniAni
あぶそる	Absol
アポロ11号	Apollo 11
アラジン	Arazin
アレク	Aleck
アンサンブル止血	Ensemble Siketu
あんず	anzu
あんぱんおいしい	Anpanoisii
イア	Ira
いしはらまや	Ishihara Maya
いどぅー	Idou
イナ_フェノン	Ina_Phenon
いらん	Ellaan
イルミー	ILM
いんぜりー	Injelly
ウーバー	Uver
ゔぁるとん	Valtone
うおおおおお	Uooooo
うりぼう	Wrybow
ウンヨン	Unnyon
えーじ	AGE
エース	Ace
えあ	Air
エイリアンドラゴン	Eirian Doragon
エヴィ_アスタリスク	Evi_Asterisk
えくしえ	Exie
えす	S
エディー	Eddie
エヌ	N
えむえむ	EMUemu
エムスター	Emustar
エメラルド	Emerald
えりー	Ellie
えりーと	Elite
エリンギ大好きトルネード歯医者	Eringi Daisuki Tornado Haisha
エルオン	Elon
えれく	Eleck
おいじょーじ	Oi, George
おうし	Oushi
おうとつ	Outotsu
おおたく	Ohtaku
おおもり	Oomori
おがとう	Ogatou
おサム	Awesome
おすしっくす	Osusix
オスマン	Osman
おぼろ	oBoRo
オルカン	Orkan
オレオ	OLEO
カゲツ	Kagetu
かずえる	KAZelu
かっぱまき	KaPMk
ガム	GAM
カム子の生足美脚ドリル	Kamuko no Namaashi Bikyaku Doriru
ガラナ	Guarana
かりこむ	Karlycom
かりんとう	Karintou
かるぅと	Karuut
かんさいのひと	Kansai no Hito
きせのんゼルダ 	Kisenon Xelda
きなこもち	Kinako Moti
きゃみ	Cami
きゃらめる	Caramel
きん	Kinn
きんてろ	Quintero
ぎんなる	Ginnar
グーレン	Gullen
くつべら	Kutubera
グラディウス	Gradius
クラム	Curamu
グリンカッツ	Grenkuts
くるみす	Kurumis
クローソン	Clauson
くろうさ	Kurousa
くろうと	Kurouto
くろすけ	Croske
ぐんぐにる	Gungnir
ぐんそう	Gunsou
けいてぃ	Keity
けいにん	Kei Nin
ケイン小杉	Kein Kosugi
けえぬ	K.A.N
けんぴ	Kenpi
けんぴん	Kengping
けん玉	Kentama
ごうち	Gouchi
ココア	Cocoa
ここみる	Kokomill
こじかよしお	Kojika Yoshio
こめにくしお	Kome Niku Sio
コリンク911	KORINKU911
サークル	Circle
サーロイン	Siroin
サエル	saL
サカマキ	SakaMaki
サクラカイロウ	Sakura Kairou
サザンバニラotan	Sazanvanillaotan
さてら	Satella
さと氏	Satoshi
さまーづ	Samars
さらだばー	Saladbar
サロメイト	Salomeito
サンリー	Sunry
しー	Sy
しおまさ	Siomasa
シガナ	Sigana
しざ	Siza
しずくもち	Sizukumochi
シダレザクラ	Sidarezakura
しっぷ	Sippu
ジブにゃ	Jibnya
ジャイロでいきます	Gyro de Ikimasu
シャイン	Syainn
じゃぐち	Jaguti
ジャック	Jack
シャドウ	syadou
しゃろ	Syaro
シャロペトラ	Syaropetora
シューマイ	Syumy
しゅうまい	syumai
シュピ	Syupi
じょーじ	George
しょーゆ	Syoyu
ショウ	Sho
しょうちゃんまる	Syochanmaru
ショコボ	Shocobo
しょぼん	syobbon
シリコン	Sirikon
しりょうと	Siryouto
しろ	Siro
シロぬこ	Sironuk0
じんクローン	jinclone
シンジオリジン	Shinji Origin
じんぜん好きだよ	Zinzen Sukidayo
スー	Suu
ずー	zoo
スガなんです	Suga Nandesu
ズズバ	Zuzunba
すみおーーー	Sumio---
スモーク	Smoke
ズヤ	zuya
ゼロール	Zeroll
ぞーん	ZONe
ぞーん@グウェンドリン	ZONe@Gwendolyn
そうかる	Soukaru
ダークサムス様	Dark Samus-sama
たいがー	Tiger
だいこんおろし	Daikon Oroshi
タイソンJr	TysonJr
ダイナ	Dyna
たいほう	Taihou
タイミングはかせ	Timinghakase
ダイヤル	DiAL
たかちゃ	Takatya
タカにぃ	Takanii
タカ氏	Takashi
たけちい	Takechy
たこちょこ	Takochoco
たっきー	Takky
だっきゅうゴリラ	Dakkyu Gorilla
たてつ	Tattsu
ダマグモキャノン	Dama Gumo Cannon
たまどらむ	Tamadrum
たみふる	Tamiflu
ちぇるの	Cherno
ちちぶトラベル	Chichibu Travel
ちむ	Timu
チャートやつ	Chart-Yatsu
チャック	Tyakku
ちょこ	Choco
ちょっぱー	Choppar
ちよなる	Chonal
ツギお	Tugio
ツッカー	Tukka
つばすわ	Tubasuwa
つも	Tumo
てぃゆ	Thiyu
てぃんくる	Twinkle
でぇきち	Deekiti
テオナ	Theona
テト	Tet.
てなー	Tener
テビッグ	HandBig
てらtr	
デラルド	Derald
てるテル	Teltel
てろり	Teroli
てんぐどの	Tengdono
でんこた	denKOTA
どーしぃ	Dorsey
どぅーか	Dooka
とうふさん	Tofu-san
とど	To do~
トム	Tom
とらさん	Torasann
ドラマチックパスタ	Dramatic Pasta
ドラ右	Doramigi
トリガー	TRIGGER
とるこ	Tolco
ナイスごんちゃ	Nice Goncha
ないとうまちこ	Naito Machiko
なえっくす	Naex
なさ	NASA
ナツメグ	Natumegu
ニックネーム	Nickname
ニャツ/レールガン	Nyatu/Railgun
にんじんざむらい	Ninjin Zamurai
にんじんせろり	Ninjin Celery
にんば	Nimba
ネクト	Nekto
ネルク	Nelk
ノーブル	Noble
のかみすぶーた	Nokami Suputa
のすたる	Nostal
のり	Nyori
ハードウェア	Hardware
ばーびょん	Barbyon
ハーブ	Herb
ばけっち	Bucketti
はしも	HASHIMO
ばしょう	Basyou
はすいろ	hasuiro
ぱすてる	Pastel
バソ	Vasso
バタ子	Batako
はっさー	Hasa
バッサー	Basser
バッファロー	Buffalo
ばにら	Vanilla
バニラ	Vanilla
バブー	Baboo
ばぷお	bapuo
はまちい	Hamachi
はむ	Ham
はやっしー	hayassy
ぱる	paru
はるきーじお	Harchisio
はるっち	Harutti
はるん	Haruuun
ぱをん	Pawon
ばんぶー	Banbuu
ばんぶぅ	Bamboo
ぴいや	Piya
ぴいや	P YA
ぴおにー	Peony
びすこーど	Biscord
ぴそら	Pisola
ひだかドラピオン	Hidaka Drapion
ビッグパルメちゃん	Big Parme-chan
ビッグロバ	Big Loba
ひなカス	hinaks
ヒョウセキ	Hyoseki
ビリー	Billy
ひろ	hiro
ふぁーむ	Farm
ファスター	Faster
フィー桜	Phisakura
フィリップ	FILIP
フェレくま	Ferretkuma
フェンリス	Fenris
ふぉーす	force
フギンムニン	Fuginmnin
ふたりのきわみアー!	Futari no Kiwami Ah~!
ふたりのきわみアー！	Futari no Kiwami Ah~!
ブドー酒	Budoshu
ふは	Huha
ぷふれ	Pfle
ふゆすぅ	Furusuu
フラウト	Flauto
ふららら麺	Furararamen
プリスキー	Purisky
プリンでいきます	Purin de Ikimasu
ぶるーえむ	BlueM
ぶるぅ	Blue
ぷるえいと	Purueight
フルパワー田中	Fullpower Tanaka
プレーヤー 4	player 4
ぶれいぶ	Brave
ベリ	Beli
べるくん	Bell-kun
ぺるんな	pelnna
ペンペン中将 ぺんちゅー	Penpen Chujo Penchu
ぽーだす	Pohdas
ボードン	Boarden
ボール#おにぎりゃー	Ball#Onigiryaa
ぽこぱんつ	Pokopants
ポッチャマ	Pochama
ホパチャイ	Hopachay
ぽぴー	POPPY
ぼぶ	Bobb
ポポス	Popos
ボマー	Bomer
ほみっちゅんだー	HomiTunder
ポムポム	POMUPOMU
ぽんたる	Ponntaru
まーる	Marl
マイルズ	Miles
まきしぃ	Maxi
まきの定食	Makinoteishoku
マサロトム	MasaRotom
まちゃまっちゃ	Matyamattya
まつたく	Matutaku
まっつん	Matsun
マトモ	Matom0
マネーライト	Moneyright
まるまて	marumate
ミーゼス	Mises
みずかめこめこ	Mizukame Komeko
みすと	Mist
みつ	Mitu
みつきー	mitsuky
みなみつ	Minamitu
ミナル	Minal
ムー	mone
ムース	Muusu
むぎちら	Mujitira
めーりす	meiris
メーリン	Maylin
メアリー	Mary
メイプル	Maple
めんぼぉ	MenBow
モーリス	Morlis
もしもし	Mosimosi
もちい	Moti
もちたま	Motitama
もちもちもっちっちー	Motimotimottitti
もっつぁん	Mottsuan
モナコインオタク	Monacoin Otaku
モミアゲイツ	momiageitsu
モルさん	Molsan
もるぴす	Molpiss
モンガチ	Mongati
やおーのきわみアー	Yao no Kiwami Ah~
やしふう	Yasifuu
ヤッツ46さい	Yutzu46Sai
やっほーん	Yahhonn
やまないと	Yamanight
ヤマナクション	Yamanaction
やみねこパンチ	Yaminekopunch
ヤンセン	Jansen
ユーノ	U-NO
ゆーふぉ	Eupho
ゆうぼん	Yuubon
ゆず	yuzu
ゆづ	Yuz
ゆらりず	Yuralyz
よーよー	Youyou
よいしょ	Yoisyo
ヨガンチュ	Yogannchu
よしのかみー	Yoshinokamy
よっちー	Yocchi
よっちゃん/よしあき	Yocchan/Yoshiaki
よっぴー	Yoppy
らいあん将軍	Ryan Shogun
らいじんぐ	Rising
ライトニングいがらし	LightningIgarashi
らくちんし	Rakutinshi
ラックス	Lax
らてぇ	Latte
ラピ	Lapi
ラピシオン	Lapixion
ラブゴリラ	Lovegorilla
らま	Lama
らららし	Lararashi
らりほんkids	Rarihonnkids
らんたん	Lantern
ランドぼくめつたい	Lando Bokumetsutai
りーマック	LiiMac
リーロン	Lulang
りえっと	Riet
リオン	RioN
りくると	Recruit
りすと	LISUTO
リトルマイク	Little Mike
りゅーおー	Ryuoh
ルート389	Route 389
ルイス	Ruishu
ルキナンスキー	Lucinansky
るけたす	ruketasu
ルシフェリン	Luciferin
ルミナス	Luminous
レイブン	Raven
レオンハート	LeonHeart
れくさす	Lexus
れじん	Resin
れっく	REC
ロキてんどんまん	RokiTendonman
ロック	Rock
ろっしー	Rossy
わこー^	Waco^
わっくす	WAX
わっしょいわたなべ	Wasshoi Watanabe
ヱヰリリ	Ailili
ヲォカズ	Wocuz
んあ	@Na
七味大福	Sitimi Daifuku
也澤	Narisawa
交通	Koutuu
仝仝仝仝	Dodododo
佳村かえる	Yoshimura Kaelu
使い魔さなたん	Tsukaima Sanatan
八神	Yagami
冷蔵庫	Reizoko
削り節	Kezuribusi
古戸らき	FurudoLaki
古森霧	komorikiri
垢BANちゃん	AkaBAN-chan
夢色雫	Yumeiro Shizuku
天地	Tenchi
姉崎	Anesaki
山田重道	Yamada Shigemichi
島田	Shimada
悪夢	Akumu
愛しのヨッシー	Itoshino Yoshi
戦士	Senshi
新米.	Shinmai
日ノ丸	Hinomaru
最弱犬	Saijaku Inu
朝比奈	Asahina
朧月夜	OvOrozukiyo
本こうすけ	Hon Kosuke
楓木	kaedegi
殺武神	Sobugami
毒ガス丸	Dokugasumaru
水戸COME ON	MitoCOME ON
水族館	Suizokukan
水面	Minamo
氷砂糖	Korizato
洋風	Yofu
満足	Manzoku
炭酸水	Tansansui
点P	TenP
狐温	Kitsune Yutaka
狐狐	Mitsuneko
猫好き社長	Nekosuki Syatyo
獄虎	Gokutora
玲桜	Leo
理央	Rio
瓶	Bin
生茶々	namachacha
眼奈実愛	Me Nami Ai
碧	Aoi
社畜おしず#きさやぎ	Shachiku Oshizu#Kisayagi
祈	Inori
神楽	Kagura
秘剣	Hiken
笹塚かいわれ	Sasazuka Kaiware
紅	Kurenai
綾月	Ayatuki
腰痛	Yotsu
英姫	Hideki
莉森	Rimori
葉月	Hazuki
虎川	Torakawa
虹のゴキブリ	Niji no Gokiburi
蛇笏	Dakotsu
蛍光	Keiko
賢者	Kenja
赤滝	Akataki
野比のび太	Nobi Nobita
金欠病	Kinketu Byo
錯覚	Sakkaku
阿修羅真那	Ashura Mana
雨地	Amachi
鬼さん	Oni-san
鳥さみる	Torisamiru
鶴岡松太郎	Tsuruoka Matsutaro
麗華真希花	Reika Makihana
黄金虫	Koganemushi
黒船	Kurofune
龍門	Ryumon